Doa Penawar Duka dan Kesedihan - Ustadz Khalid Basalamah :::: Doa Penawar Duka dan Kesedihan - Ustadz Khalid Basalamah
Sedekah Penolong Mu Di Hari Kiamat - Ustadz Khalid Basalamah :::: Sedekah Penolong Mu Di Hari Kiamat - Ustadz Khalid Basalamah
Bersabarlah dan Jangan Berkeluh Kesah - Ustadz Khalid Basalamah :::: Bersabarlah dan Jangan Berkeluh Kesah - Ustadz Khalid Basalamah
Cara Bersyukur Yang Baik & Benar - Ustadz Khalid Basalamah :::: Cara Bersyukur Yang Baik & Benar - Ustadz Khalid Basalamah
Ajaran Rasulullah Tentang Menyikapi Fitnah - Ustadz Khalid Basalamah :::: Ajaran Rasulullah Tentang Menyikapi Fitnah - Ustadz Khalid Basalamah
Menjaga Hubungan Dengan Allah - Ustadz Khalid Basalamah :::: Menjaga Hubungan Dengan Allah - Ustadz Khalid Basalamah
Kembali Kepada Allah - Ustadz Khalid Basalamah :::: Kembali Kepada Allah - Ustadz Khalid Basalamah
Kamu Pasti Akan Diuji - Ustadz Khalid Basalamah :::: Kamu Pasti Akan Diuji - Ustadz Khalid Basalamah
Baca & Bukalah Al - Quran Mu - Ustadz Syafiq Riza Basalamah :::: Baca & Bukalah Al - Quran Mu - Ustadz Syafiq Riza Basalamah
Jangan Pernah Kamu Berhenti Berdoa - Ustadz Syafiq Riza Basalamah :::: Jangan Pernah Kamu Berhenti Berdoa - Ustadz Syafiq Riza Basalamah
Bersabarlah Saat Diuji Ataupun Diberi Musibah - Ustadz Syafiq Riza Basalamah :::: Bersabarlah Saat Diuji Ataupun Diberi Musibah - Ustadz Syafiq Riza Basalamah
Perempuan Yang Bercita - Cita Menjadi Da'i - Ustadz Syafiq Riza Basalamah :::: Perempuan Yang Bercita - Cita Menjadi Da'i - Ustadz Syafiq Riza Basalamah
Cara Berdamai Dengan Masa Lalu - Ustadz Syafiq Riza Basalamah :::: Cara Berdamai Dengan Masa Lalu - Ustadz Syafiq Riza Basalamah
Bila Kamu Menafkahi Keluarga dengan Harta Haram - Ustadz Syafiq Riza Basalamah :::: Bila Kamu Menafkahi Keluarga dengan Harta Haram - Ustadz Syafiq Riza Basalamah
Bagaimana Masa Depan Umat Islam? - Ustadz Syafiq Riza Basalamah :::: Bagaimana Masa Depan Umat Islam? - Ustadz Syafiq Riza Basalamah
Jangan Berlebihan dalam Beribadah - Ustadz Syafiq Riza Basalamah :::: Jangan Berlebihan dalam Beribadah - Ustadz Syafiq Riza Basalamah
Mengapa Kamu Menunda Pernikahan? - Ustadz Syafiq Riza Basalamah :::: Mengapa Kamu Menunda Pernikahan? - Ustadz Syafiq Riza Basalamah
Larangan Menimbun Harta - Ustadz Syafiq Riza Basalamah :::: Larangan Menimbun Harta - Ustadz Syafiq Riza Basalamah
Persiapan Mati Mendadak - Ustadz Syafiq Riza Basalamah :::: Persiapan Mati Mendadak - Ustadz Syafiq Riza Basalamah
Al - Quran Obat dari Segala Penyakit - Ustadz Syafiq Riza Basalamah :::: Al - Quran Obat dari Segala Penyakit - Ustadz Syafiq Riza Basalamah
Ketika Rasulullah Bercerita - Ustadz Syafiq Riza Basalamah :::: Ketika Rasulullah Bercerita - Ustadz Syafiq Riza Basalamah
Ciri - Ciri Kamu Kerasukan Jin & Syaithon - Ustadz Syafiq Riza Basalamah :::: Ciri - Ciri Kamu Kerasukan Jin & Syaithon - Ustadz Syafiq Riza Basalamah
Ketika Surga dan Neraka Berbicara - Ustadz Khalid Basalamah :::: Ketika Surga dan Neraka Berbicara - Ustadz Khalid Basalamah
Larangan Merayakan Ulang Tahun - Ustadz Khalid Basalamah :::: Larangan Merayakan Ulang Tahun - Ustadz Khalid Basalamah
Rahasia Sukses Dalam Berbisnis - Ustadz Khalid Basalamah :::: Rahasia Sukses Dalam Berbisnis - Ustadz Khalid Basalamah
Istiqomah Dijalan Allah - Ustadz Khalid Basalamah :::: Istiqomah Dijalan Allah - Ustadz Khalid Basalamah
Pahami Konsep dan Apa Itu Rezeki - Ustadz Khalid Basalamah :::: Pahami Konsep dan Apa Itu Rezeki - Ustadz Khalid Basalamah
Nasihat Dari Bahayanya Riba!! - Ustadz Khalid Basalamah :::: Nasihat Dari Bahayanya Riba!! - Ustadz Khalid Basalamah
Apakah Agama Islam Yang Paling Benar?? - Ustadz Khalid Basalamah :::: Apakah Agama Islam Yang Paling Benar?? - Ustadz Khalid Basalamah
Hati Hati Berprasangka Kepada Allah - Ustadz Khalid Basalamah :::: Hati Hati Berprasangka Kepada Allah - Ustadz Khalid Basalamah
Ajarkan Anak Mu Ini Sejak Dini - Ustadz Khalid Basalamah :::: Ajarkan Anak Mu Ini Sejak Dini - Ustadz Khalid Basalamah
Kajian Tentang Orang Munafik - Ustadz Khalid Basalamah :::: Kajian Tentang Orang Munafik - Ustadz Khalid Basalamah
Kenapa Kamu Tak Kunjung Menikah - Ustadz Khalid Basalamah :::: Kenapa Kamu Tak Kunjung Menikah - Ustadz Khalid Basalamah